13,10,24,16,12,23,23,23,23,23
15,11,23,15,6,12,23,23,23,23
13,19,23,23,15,6,12,23,23,23
17,14,22,23,23,15,6,12,23,23
9,12,5,0,16,12,15,6,12,23
15,11,9,12,15,6,12,15,6,12
23,27,15,6,12,15,6,12,15,11
23,1,23,15,11,23,15,11,23,1
23,1,23,23,27,20,20,27,23,27
23,4,26,0,3,23,23,4,0,3
