22,22,22,22,22,22,22,22,22,22
5,26,0,0,0,0,0,26,2,22
1,23,23,23,23,23,23,23,1,22
1,23,23,5,0,2,5,26,3,22
27,23,23,25,21,1,4,0,0,2
9,12,23,1,21,1,20,20,20,1
15,6,12,1,21,1,20,20,20,1
22,15,11,1,21,1,20,20,20,1
22,22,27,27,21,1,20,20,20,27
22,22,9,19,21,4,26,0,0,3
