21,5,16,12,21,21,21,21,21,21
21,27,15,6,12,21,21,21,21,21
21,1,21,15,6,12,21,21,21,21
21,1,21,21,15,6,12,21,21,21
21,27,21,21,21,15,6,12,21,21
20,1,20,20,20,20,15,6,12,20
20,1,20,20,20,20,20,15,11,20
20,27,20,20,20,20,20,13,19,20
20,4,0,24,0,0,26,8,14,20
20,20,20,20,20,20,20,20,20,20
