5,0,0,0,0,0,2,23,23,23
1,21,22,22,22,21,27,23,23,23
1,21,21,22,22,21,9,10,0,2
1,21,22,21,22,21,15,18,2,1
1,21,22,22,21,21,22,13,19,1
1,22,22,22,22,13,10,8,14,1
1,22,22,22,13,7,18,0,0,3
1,22,22,13,7,14,23,23,23,23
9,12,13,7,14,23,23,23,23,23
15,18,8,14,23,23,23,23,23,23
