5,26,0,0,0,0,0,0,26,2
4,0,2,23,23,21,23,23,21,1
20,20,1,23,23,21,23,21,23,25
20,20,1,12,23,21,21,23,23,1
20,20,27,6,12,21,23,21,23,1
20,20,1,15,6,21,23,23,21,1
20,20,1,23,15,6,12,23,23,1
20,20,1,23,23,15,6,12,23,1
5,0,3,23,23,23,15,6,12,27
4,0,0,0,0,0,0,0,0,3
