21,21,21,21,20,21,21,21,21,21
21,13,10,0,24,0,0,16,12,21
20,17,14,13,7,6,12,15,11,20
21,1,13,7,14,15,6,12,1,21
21,1,7,14,23,22,15,6,1,21
20,27,20,23,22,23,22,20,27,20
21,1,23,22,23,22,23,22,1,21
21,9,12,20,22,23,20,13,19,21
21,15,18,26,0,0,26,8,14,21
21,21,21,20,21,21,20,21,21,21
