22,22,13,10,26,0,0,0,26,2
22,13,7,14,22,22,22,22,22,1
13,7,14,22,22,5,2,22,22,27
17,14,22,22,22,4,3,22,5,3
27,22,22,22,22,22,22,5,3,22
1,5,26,0,0,0,26,3,22,22
1,4,0,24,0,0,0,26,2,22
27,22,22,22,22,22,22,22,1,22
9,12,22,22,22,22,22,22,1,22
15,18,26,0,0,0,0,26,3,22
