22,13,10,0,0,2,20,5,2,22
13,7,14,22,22,1,20,27,4,2
17,14,22,22,22,27,20,1,22,1
25,22,22,5,0,3,20,1,22,1
1,22,22,9,10,0,26,3,22,1
1,22,22,17,6,12,20,22,22,1
1,22,22,1,15,6,12,20,22,1
1,22,13,19,21,15,6,12,20,1
27,13,7,14,21,20,15,6,12,27
4,8,14,20,21,20,21,15,18,3
