13,10,16,12,22,22,22,22,22,22
17,18,8,11,22,22,5,26,2,22
1,22,22,9,12,13,19,22,9,12
27,22,22,15,18,8,14,22,15,11
9,12,22,22,20,20,20,20,20,27
17,18,0,2,20,22,22,22,22,1
1,22,22,1,20,20,20,22,22,1
1,22,22,1,20,22,22,22,22,1
1,22,5,3,20,20,20,20,20,1
4,0,4,0,24,0,0,0,26,3
