22,13,10,26,0,2,20,5,2,22
13,7,14,22,22,27,20,27,4,2
17,14,22,22,22,1,20,1,22,27
25,22,22,5,0,3,20,1,22,1
1,22,22,9,10,0,26,3,22,1
1,22,22,17,18,16,12,22,22,1
1,22,22,1,21,15,6,12,22,1
1,22,13,19,21,20,15,6,12,27
27,13,7,14,21,20,21,15,6,19
4,8,14,20,21,20,21,20,15,14
