22,22,22,22,22,22,22,22,22,22
5,26,0,0,0,0,0,26,2,23
4,26,0,0,2,22,22,13,19,22
23,23,23,23,1,23,23,17,14,23
22,22,22,22,27,22,22,9,12,22
23,23,23,23,1,23,23,15,11,23
22,5,0,0,3,22,22,22,25,22
23,1,23,15,6,12,23,13,19,23
22,4,0,0,0,26,0,8,14,22
23,23,23,23,23,23,23,23,23,23
